8-BIT : Belle, Squeak, Penny, Barley, Sprout, Bo, Mina
ALLI : Doug, Trunk, Bull, R-T, Jacky
AMBER : Crow, Belle, Lily, Byron, Sprout 
ANGELO : Gray, Max, Nani, Eve, Darryl 
ASH : Frank, Trunk, Otis, Mina, Carl, Emz
BARLEY : Sprout, Tick, Griff, Kaze, Lily, Carl, Stu, Brock
BEA : Brock, Belle, Sprout, Bo, Gus
BELLE : Piper, Byron, Nani, Sprout, Mandy
BERRY : Barley, Frank, Griff, Kaze, Dynamike
BIBI : Bea, Lumi, Ash, Bull, Griff
BO : Kaze, Lily, Stu, Piper, Kenji
BONNIE : Nani, Piper, Brock, Charlie, Angelo, Tick
BROCK : Piper, Angelo, Nani, Mandy, Jae-yong, Max, Darryl, Kaze, Ollie
BULL : Tara, Cordelius, Charlie, Willow, Griff
BUSTER : Ash, Brock, Squeak, Trunk, Willow, Barley
BUZZ : Bull, Doug, Gene, Finx, Stu, Meeple, Cordelius
BYRON : Piper, Nani, Sprout, Tick, Poco, Kaze, Lily
CARL : Stu, Darryl, Buster, Colette, Crow, Gus, Buzz
CHARLIE : Squeak, Byron, Brock, Angelo, Amber, Sprout, Tick, Willow, Penny, Jae-yong, Jane
CHESTER : Squeak, Carl, Crow, Byron, Belle, Sprout, Barley, Willow
CHUCK : Kaze, Darryl, Cordelius, Mina, Melodie
CLANCY : Juju, Larry & Lawrie, Bea, Ziggy, Ruffs, Charlie
COLETTE : Belle, Byron, Bea, Crow, Squeak, Charlie, Willow
COLT : Piper, Belle, Crow, Max, Jae-yong
CORDELIUS : Sandy, Buster, Hank, Ash, Ruffs, Tara, Willow, Barley
CROW : Gus, Belle, Ruffs, Otis, Charlie, Willow, Juju
DARRYL : Tara, Charlie, Cordelius, Colette, Otis, Lou, Bea, Shelly
DOUG : Griff, Willow, Gene, Squeak, Cordelius, Charlie
DRACO : Lou, Lumi, Lola, Willow, Otis, Tara
DYNAMIKE : Mortis, Kaze, Brock, Gray, Stu, Sprout
EDGAR : Bull, Doug, Cordelius, Charlie, Stu, R-T, Gale, Mina
EL PRIMO : Bea, Griff, Lou, Finx, Dynamike, Willow
EMZ : Sprout, Barley, Crow, Squeak, Bea, Belle, Kaze, Mortis, Lily
EVE : Belle, Carl, Alli, Amber, Penny, Brock
FANG : R-T, Charlie, Cordelius, Doug, Griff
FINX : Crow, Ruffs, Otis, Bo, Barley, Belle, Byron, Spike
FRANK : Colette, El Primo, Bull, Bea, Trunk, Lumi, Lou, Maisie, Ruffs, Willow, Dynamike
GALE : Belle, Bea, Sprout, Barley, Willow, Crow, Lola, Squeak
GENE : Ruffs, Charlie, Tick, Sprout, Grom, Penny, Belle
GIGI : Doug, Buster, Gene, Willow, Bull
GRAY : Tara, Charlie, Gus, Ruffs, Eve, Brock, Jae-yong, Max, Ash, Ollie
GRIFF : Bea, Belle, Crow, Spike, Brock, Janet, Stu
GROM : Mortis, Kaze, Lily, Tick, Brock, Max, Jae-yong, Darryl
GUS : Ruffs, Byron, Angelo, Piper, Sprout, Tick, Charlie, Ash
HANK : Dynamike, Barley, Pam, Otis, Ruffs, El Primo, Frank, Lou, Bea, Lumi, Griff, Willow
JACKY : Lumi, Bea, Griff, Lou, Crow, Otis, Barley, Willow, Doug, Frank, Trunk, Spike, Cordelius, Surge
JAE-YONG : Crow, Belle, Bea, Otis, Lola, Kaze, Lily
JANET : Belle, Gus, Crow, Barley, Sprout, Otis, Squeak
JESSIE : Barley, Berry, Belle, Gus, Brock, Kaze
JUJU : Alli, Larry & Lawrie, Brock, Piper, Carl, Edgar, Griff, Barley
KAZE : Crow, Gene, Meeple, Amber, Cordelius, Otis, Doug, Buster, Meg
KENJI : Meg, Otis, Frank, Crow, Tara, Jacky, Trunk, Bea, Cordelius, Bull, Ash
KIT : Gene, Amber, Crow, Bull, Jacky
LARRY & LAWRIE : Sprout, Tick, Griff, Brock, Kaze, Mortis, Lily, Ziggy, Stu
LEON : Gene, Meg, Crow, Belle, Stu
LILY : Nita, Jacky, Buster, Bull, Gene, Cordelius, Crow
LOLA : Belle, Penny, Squeak, Byron, Sprout, Barley, Willow
LOU : Bea, Sprout, Barley, Willow, Belle, Byron, Stu, Ruffs, Poco
LUMI : Kaze, Lily, Byron, Belle, Willow, Sprout, Barley
MAISIE : Belle, Gus, Charlie, Tara, Sprout, Barley, Willow, Gene, Crow, Ruffs
MANDY : Nani, Gray, Angelo, Piper, Darryl, Kaze, Tick
MAX : Crow, Lola, Belle, Bea, Otis
MEEPLE : Ruffs, Lily, Max, Charlie, Brock, Gray, Willow, Sprout, Janet, Jessie, Moe, Pam
MEG : Crow, Colette, Lou, Amber, Byron, Belle, Finx, Barley, Larry & Lawrie, Dynamike, Bea
MELODIE : Crow, Amber, R-T, Tara, Cordelius, Charlie
MICO : R-T, Lily, Meg, Nani, Bull, Cordelius
MINA : Crow, Otis, Tara, Charlie, Sprout, Barley, Lola, Stu, Ruffs
MOE : Ruffs, Otis, Gus, Ash, Crow, Barley, Larry & Lawrie
MORTIS : Jacky, Doug, Shelly, Bull, Cordelius, Nita, Stu, Maisie, Griff, Gus
MR. P : Carl, Ollie, Mortis, Byron, Squeak
NANI : Max, Gene, Leon, Jae-yong, Tick, Eve
NITA : Otis, Griff, Barley, Larry & Lawrie, Dynamike, Amber, Lumi
OLLIE : Lumi, Buster, Gene, Poco, Cordelius
OTIS : Belle, Gus, Bea, Barley, Willow, Squeak
PAM : Ruffs, Barley, Larry & Lawrie, Bea, Belle, Lola, Penny, Squeak, Colette
PEARL : Brock, Gene, Tick, Barley, Belle, Bea, Gus, Lola, Squeak
PENNY : Belle, Byron, Nani, Squeak, Sprout, Barley, Carl, Berry, Bo, Brock
PIPER : Nani, Max, Jae-yong, Kaze, Tick, Sprout
POCO : Lola, Crow, Belle, Kaze, Mortis, Barley, Dynamike, Willow
RICO : Squeak, Sprout, Barley, Carl, Stu, Griff, Brock, Kaze, Buzz
ROSA : Frank, Amber, Otis, Lumi, Lola, Crow
R-T : Charlie, Sprout, Barley, Willow, Eve, Squeak, Brock, Ruffs
RUFFS : Squeak, Barley, Sprout, Angelo, Byron, Penny, Janet
SAM : Bea, Frank, Trunk, Bull, Otis
SANDY : Barley, Juju, Larry & Lawrie, Emz, Amber, Crow, Griff
SHADE : Hank, Jacky, Bull, Trunk, Cordelius, Doug, Meeple, Frank, Stu, Buzz
SHELLY : Bea, Tara, Gus, Ash, Barley, Sprout
SPIKE : Belle, Gus, Byron, Sprout, Barley, Penny, Jae-yong, Carl, Janet
SPROUT : Tick, Kaze, Brock, Stu, Lily, Mortis
SQUEAK : Darryl, Trunk, Nani, Piper, Brock, Kaze, Lily, Buzz, Sprout, Tick
STU : Gus, Belle, Lola, Ruffs, Crow, Tara, Charlie, Poco, Bea
SURGE : Ruffs, Ash, Gus, Bea, Belle, Barley, Willow, Tara, Spike, Charlie, Otis
TARA : Janet, Sprout, Barley, Willow, Byron, Carl, Amber, Sandy, Jae-yong, Buster
TICK : Alli, Gray, Piper, Angelo, Brock, Max, Kaze, Lily, Jae-yong
TRUNK : Griff, Bea, Lumi, Frank, Hank, Draco
WILLOW : Barley, Sprout, Brock, Lily, Kaze, Stu, Alli
ZIGGY : Mortis, Lily, Kaze, Piper, Brock, Darryl, Trunk, Max, Jae-yong